,1,1,1,1,1,1,1,1,1,1,1,1,1,1,1,1,1,1,1,1
,1,0,0,0,0,1,1,1,6,5,6,5,1,1,1,0,0,0,0,1
,1,0,0,0,0,1,1,6,0,0,0,0,5,1,1,0,0,0,0,1
,1,0,0,0,0,1,6,0,0,0,0,0,0,5,1,0,0,0,0,1
,1,0,0,0,0,6,0,0,0,0,0,0,0,0,5,0,0,0,0,1
,1,0,0,0,0,4,0,0,0,0,0,0,0,0,3,0,0,0,0,1
,1,0,0,0,0,1,4,0,0,0,0,0,0,3,1,0,0,0,0,1
,1,0,0,0,0,1,1,4,0,0,0,0,3,1,1,0,0,0,0,1
,1,0,0,0,0,1,1,1,4,9,0,3,1,1,1,0,0,0,0,1
,1,1,1,1,1,1,1,1,1,1,1,1,1,1,1,1,1,1,1,1
