,1,1,1,1,1,1,1,1,1,1,1,1,1,1,1,1,1,1,1,1
,1,0,0,0,0,0,0,0,0,0,0,0,0,0,0,0,0,0,0,1
,1,0,0,0,0,0,0,0,0,0,0,0,0,0,0,0,0,0,0,1
,1,0,0,0,0,0,0,0,0,0,0,13,0,0,0,0,0,0,0,1
,1,0,0,0,0,0,13,0,0,0,0,1,0,0,0,0,0,0,0,1
,1,0,9,0,0,0,0,0,0,0,1,1,0,0,0,0,0,0,0,1
,1,0,0,0,0,0,0,0,1,1,1,0,0,0,0,0,0,0,0,1
,1,0,0,0,0,0,0,0,1,1,0,0,0,0,0,0,0,0,0,1
,1,0,0,0,0,3,1,1,1,0,13,0,0,0,0,11,0,0,0,1
,1,1,1,1,1,1,1,1,1,1,1,1,1,1,1,1,1,1,1,1
