,2,2,2,2,2,2,2,2,2,2,2,2,2,2,2,2,2,2,2,2
,2,0,0,0,0,2,2,2,6,5,6,5,2,2,2,0,0,0,0,2
,2,0,0,0,0,0,0,0,0,0,0,0,0,0,0,0,0,0,0,2
,2,0,8,0,0,0,0,0,0,0,0,0,0,0,0,0,0,8,0,2
,2,0,0,0,0,0,0,0,0,0,0,0,0,0,0,0,0,0,0,2
,2,0,0,0,0,0,0,0,0,0,0,0,0,0,0,0,0,0,0,2
,2,0,0,0,0,0,13,0,0,0,0,0,0,13,0,0,0,0,0,2
,2,7,0,0,0,1,1,0,0,0,0,0,0,3,1,0,7,0,0,2
,2,0,0,0,1,2,2,1,0,9,0,12,3,1,2,11,13,0,0,2
,2,1,1,1,1,1,1,1,1,1,1,1,1,1,1,1,1,1,1,2
