,1,1,1,1,1,1,1,1,1,1,1,1,1,1,1,1,1,1,1,1
,1,0,0,0,0,0,0,0,0,0,0,0,0,0,0,0,0,0,0,1
,1,0,0,0,0,0,0,13,0,0,0,0,0,0,0,0,0,0,0,1
,1,0,9,0,0,0,0,0,0,0,0,0,0,0,0,0,0,0,0,1
,1,0,0,0,0,0,0,0,0,0,0,0,0,0,0,0,0,0,0,1
,1,0,0,0,0,0,1,1,1,0,0,0,0,0,0,0,0,0,0,1
,1,0,0,0,0,1,6,0,5,1,0,0,0,0,0,0,0,0,0,1
,1,0,0,0,1,0,0,0,0,0,0,0,0,0,0,0,0,0,0,1
,1,0,0,0,1,13,0,0,0,11,0,0,0,0,0,13,0,0,0,1
,1,1,1,1,1,1,1,1,1,1,1,1,1,1,1,1,1,1,1,1
